1111111111111
1P011C000C001
1100111001101
1000C1E001101
1000111C001C1
100C000C00U01
1111111111111
